{
    "legend": {
      "#": "Wall (solid, cannot pass)",
      " ": "Empty floor (walkable)",
      "P": "Player 1 starting position",
      "Q": "Player 2 starting position",
      "B": "Box (movable, can only push 1 at a time)",
      ".": "Target (goal where a box must be pushed)"
    },
    "levels": [
      [
        ["#", "#", "#", "#", "#", "#", "#", "#"],
        ["#", "P", " ", "B", " ", ".", "Q", "#"],
        ["#", " ", " ", " ", " ", " ", " ", "#"],
        ["#", " ", "B", " ", " ", "B", " ", "#"],
        ["#", " ", " ", " ", " ", " ", " ", "#"],
        ["#", ".", " ", ".", " ", " ", " ", "#"],
        ["#", "#", "#", "#", "#", "#", "#", "#"]
      ],
      [
        ["#", "#", "#", "#", "#", "#", "#", "#"],
        ["#", "P", " ", "B", " ", ".", "Q", "#"],
        ["#", " ", " ", " ", "#", " ", " ", "#"],
        ["#", " ", "B", " ", " ", "B", " ", "#"],
        ["#", "#", " ", "#", "#", " ", " ", "#"],
        ["#", ".", " ", ".", " ", " ", " ", "#"],
        ["#", "#", "#", "#", "#", "#", "#", "#"]
      ],
      [
        ["#", "#", "#", "#", "#", "#", "#", "#"],
        ["#", " ", " ", " ", " ", " ", " ", "#"],
        ["#", ".", " ", " ", "#", " ", "Q", "#"],
        ["#", "#", " ", "#", "#", "B", "#", "#"],
        ["#", "#", "B", "#", "#", " ", "#", "#"],
        ["#", ".", "P", " ", " ", " ", " ", "#"],
        ["#", "#", "#", "#", "#", "#", "#", "#"]
      ],
      [
        ["#", "#", "#", "#", "#", "#", "#", "#"],
        ["#", " ", ".", " ", "B", " ", "Q", "#"],
        ["#", "#", "#", " ", "#", " ", "#", "#"],
        ["#", ".", " ", " ", " ", "B", " ", "#"],
        ["#", "#", "B", "#", "#", " ", "#", "#"],
        ["#", "P", " ", " ", ".", " ", " ", "#"],
        ["#", "#", "#", "#", "#", "#", "#", "#"]
      ],
      [
        ["#", "#", "#", "#", "#", "#", "#", "#"],
        ["#", " ", ".", "B", " ", ".", "Q", "#"],
        ["#", "#", "#", " ", "#", "B", "#", "#"],
        ["#", ".", " ", "B", " ", " ", " ", "#"],
        ["#", "#", "#", "#", "#", "B", " ", "#"],
        ["#", "P", " ", ".", " ", " ", " ", "#"],
        ["#", "#", "#", "#", "#", "#", "#", "#"]
      ],
      [
        ["#", "#", "#", "#", "#", "#", "#", "#"],
        ["#", "P", " ", "B", " ", ".", "Q", "#"],
        ["#", ".", "#", " ", "#", ".", " ", "#"],
        ["#", " ", "B", " ", "B", " ", " ", "#"],
        ["#", " ", " ", "#", "#", "B", " ", "#"],
        ["#", " ", ".", " ", " ", " ", " ", "#"],
        ["#", "#", "#", "#", "#", "#", "#", "#"]
      ]     

    ]
  }
  